State/UTs,Crime Head,Year,Cases Pending Investigation from Previous Year,Cases reported during the year,No. of cases withdrawn by the Govt. during investigation,Cases not investigated or in which investigation was refused,Cases declared false on account of mistake of fact or of law,Cases in which chargesheets were laid,Cases in which charge-sheets were not laid but final report submitted during the year,Total cases (Chargesheeted + Final Report submitted),Cases pending investigation at the end of the year,Cases pending trial from the previous year,Cases sent for trial during the year,No. of cases withdrawn by the Govt.,Total cases for trial during the year,Cases compounded or withdrawn,Cases in which trials were completed,Cases convicted,Cases acquitted or discharged,Cases pending trial at the end of the year
Andhra Pradesh,Dowry Deaths,2013,312,492,0,0,32,448,1,449,323,1307,448,0,1755,3,452,52,400,1300
Arunachal Pradesh,Dowry Deaths,2013,1,0,0,0,0,1,0,1,0,0,1,0,1,0,0,0,0,1
Assam,Dowry Deaths,2013,268,170,0,0,0,103,19,122,316,465,103,0,568,0,68,23,45,500
Bihar,Dowry Deaths,2013,1399,1182,0,0,96,1066,128,1194,1291,5344,1066,0,6410,72,577,149,428,5761
Chhattisgarh,Dowry Deaths,2013,8,109,0,0,0,97,1,98,19,414,97,0,511,1,98,28,70,412
Goa,Dowry Deaths,2013,1,0,0,0,0,1,0,1,0,9,1,0,10,0,2,1,1,8
Gujarat,Dowry Deaths,2013,5,29,0,0,0,29,0,29,5,503,29,0,532,0,26,1,25,506
Haryana,Dowry Deaths,2013,34,263,0,0,36,233,1,234,27,467,233,0,700,0,261,82,179,439
Himachal Pradesh,Dowry Deaths,2013,0,0,0,0,0,0,0,0,0,22,0,0,22,0,3,0,3,19
Jammu & Kashmir,Dowry Deaths,2013,2,7,0,0,2,6,0,6,1,60,6,0,66,0,9,1,8,57
Jharkhand,Dowry Deaths,2013,301,307,0,0,8,247,36,283,317,527,247,0,774,0,216,96,120,558
Karnataka,Dowry Deaths,2013,70,277,0,3,11,225,13,238,95,768,225,0,993,3,146,24,122,844
Kerala,Dowry Deaths,2013,25,21,0,0,0,21,0,21,25,182,21,0,203,0,6,1,5,197
Madhya Pradesh,Dowry Deaths,2013,69,776,0,0,0,753,1,754,91,2337,753,0,3090,10,677,220,457,2403
Maharashtra,Dowry Deaths,2013,114,320,0,0,2,328,4,332,100,3764,328,0,4092,3,209,17,192,3880
Manipur,Dowry Deaths,2013,2,0,0,0,0,0,0,0,2,0,0,0,0,0,0,0,0,0
Meghalaya,Dowry Deaths,2013,5,2,0,0,0,1,0,1,6,6,1,0,7,0,0,0,0,7
Mizoram,Dowry Deaths,2013,0,0,0,0,0,0,0,0,0,0,0,0,0,0,0,0,0,0
Nagaland,Dowry Deaths,2013,0,1,0,0,0,0,0,0,1,0,0,0,0,0,0,0,0,0
Odisha,Dowry Deaths,2013,444,395,0,0,13,397,7,404,422,1777,397,0,2174,0,224,29,195,1950
Punjab,Dowry Deaths,2013,97,126,0,0,6,93,3,96,121,301,93,0,394,0,120,66,54,274
Rajasthan,Dowry Deaths,2013,83,453,0,0,95,349,1,350,91,1863,349,0,2212,11,220,97,123,1981
Sikkim,Dowry Deaths,2013,2,0,0,0,0,2,0,2,0,2,2,0,4,0,4,2,2,0
Tamil Nadu,Dowry Deaths,2013,131,118,0,0,1,118,5,123,125,565,118,0,683,0,112,27,85,571
Tripura,Dowry Deaths,2013,19,29,0,0,0,36,2,38,10,118,36,0,154,0,12,3,9,142
Uttar Pradesh,Dowry Deaths,2013,400,2335,0,0,96,1864,216,2080,559,7435,1864,0,9299,45,1410,690,720,7844
Uttarakhand,Dowry Deaths,2013,11,43,0,0,1,34,6,40,13,172,34,0,206,1,57,31,26,148
West Bengal,Dowry Deaths,2013,538,481,0,0,0,437,3,440,579,2565,437,0,3002,0,288,33,255,2714
West Bengal,Dowry Deaths,2013,538,481,0,0,0,437,3,440,579,2565,437,0,3002,0,288,33,255,2714
A&N Islands,Dowry Deaths,2013,1,1,0,0,0,1,0,1,1,6,1,0,7,0,0,0,0,7
Chandigarh,Dowry Deaths,2013,1,1,0,0,0,1,0,1,1,6,1,0,7,0,5,2,3,2
D&N Haveli,Dowry Deaths,2013,0,0,0,0,0,0,0,0,0,2,0,0,2,0,0,0,0,2
Daman & Diu,Dowry Deaths,2013,0,0,0,0,0,0,0,0,0,0,0,0,0,0,0,0,0,0
Delhi UT,Dowry Deaths,2013,73,144,0,0,1,121,4,125,91,887,121,0,1008,0,82,33,49,926
Lakshadweep,Dowry Deaths,2013,0,0,0,0,0,0,0,0,0,0,0,0,0,0,0,0,0,0
Puducherry,Dowry Deaths,2013,1,1,0,0,0,1,0,1,1,14,1,0,15,0,0,0,0,15
Andhra Pradesh,Dowry Prohibition Act,2013,1063,1631,0,0,82,1570,115,1685,927,3268,1570,0,4838,675,1081,44,1037,3082
Arunachal Pradesh,Dowry Prohibition Act,2013,0,0,0,0,0,0,0,0,0,0,0,0,0,0,0,0,0,0
Assam,Dowry Prohibition Act,2013,65,40,0,0,0,56,4,60,45,208,56,0,264,0,23,3,20,241
Bihar,Dowry Prohibition Act,2013,1008,1893,0,0,166,1284,158,1442,1293,5297,1284,0,6581,83,658,144,514,5840
Chhattisgarh,Dowry Prohibition Act,2013,0,11,0,0,0,10,0,10,1,31,10,0,41,0,6,3,3,35
Goa,Dowry Prohibition Act,2013,0,0,0,0,0,0,0,0,0,0,0,0,0,0,0,0,0,0
Gujarat,Dowry Prohibition Act,2013,0,84,0,0,0,66,2,68,16,27,66,0,93,0,13,0,13,80
Haryana,Dowry Prohibition Act,2013,2,13,0,0,4,7,2,9,2,20,7,0,27,0,5,1,4,22
Himachal Pradesh,Dowry Prohibition Act,2013,0,2,0,0,0,0,0,0,2,15,0,0,15,3,2,0,2,10
Jammu & Kashmir,Dowry Prohibition Act,2013,11,3,0,0,1,2,0,2,11,19,2,0,21,0,0,0,0,21
Jharkhand,Dowry Prohibition Act,2013,639,1428,0,0,36,983,126,1109,922,1056,983,0,2039,22,774,177,597,1243
Karnataka,Dowry Prohibition Act,2013,626,1693,0,12,157,1265,19,1284,866,2910,1265,0,4175,19,682,19,663,3474
Kerala,Dowry Prohibition Act,2013,6,3,0,0,0,4,1,5,4,20,4,0,24,0,1,1,0,23
Madhya Pradesh,Dowry Prohibition Act,2013,1,72,0,0,0,70,0,70,3,272,70,0,342,1,31,18,13,310
Maharashtra,Dowry Prohibition Act,2013,4,43,0,0,2,36,0,36,9,308,36,0,344,4,36,5,31,304
Manipur,Dowry Prohibition Act,2013,0,0,0,0,0,0,0,0,0,0,0,0,0,0,0,0,0,0
Meghalaya,Dowry Prohibition Act,2013,0,0,0,0,0,0,0,0,0,0,0,0,0,0,0,0,0,0
Mizoram,Dowry Prohibition Act,2013,0,0,0,0,0,0,0,0,0,0,0,0,0,0,0,0,0,0
Nagaland,Dowry Prohibition Act,2013,0,0,0,0,0,0,0,0,0,0,0,0,0,0,0,0,0,0
Odisha,Dowry Prohibition Act,2013,901,2014,0,0,44,1853,36,1889,982,4637,1853,0,6490,0,521,57,464,5969
Punjab,Dowry Prohibition Act,2013,5,3,0,0,1,3,1,4,3,13,3,0,16,0,3,2,1,13
Rajasthan,Dowry Prohibition Act,2013,0,57,0,0,27,27,0,27,3,24,27,0,51,4,9,3,6,38
Sikkim,Dowry Prohibition Act,2013,0,0,0,0,0,0,0,0,0,0,0,0,0,0,0,0,0,0
Tamil Nadu,Dowry Prohibition Act,2013,71,305,0,0,17,252,21,273,86,517,252,0,769,0,150,30,120,619
Tripura,Dowry Prohibition Act,2013,0,1,0,0,0,0,0,0,1,2,0,0,2,0,0,0,0,2
Uttar Pradesh,Dowry Prohibition Act,2013,182,1277,0,0,9,750,67,817,633,702,750,0,1452,3,184,112,72,1265
Uttarakhand,Dowry Prohibition Act,2013,0,0,0,0,0,0,0,0,0,3,0,0,3,0,1,0,1,2
West Bengal,Dowry Prohibition Act,2013,161,107,0,0,0,89,0,89,179,257,89,0,346,0,20,0,20,326
West Bengal,Dowry Prohibition Act,2013,161,107,0,0,0,89,0,89,179,257,89,0,346,0,20,0,20,326
A&N Islands,Dowry Prohibition Act,2013,0,0,0,0,0,0,0,0,0,1,0,0,1,0,0,0,0,1
Chandigarh,Dowry Prohibition Act,2013,1,0,0,0,0,1,0,1,0,0,1,0,1,0,1,0,1,0
D&N Haveli,Dowry Prohibition Act,2013,0,0,0,0,0,0,0,0,0,1,0,0,1,0,0,0,0,1
Daman & Diu,Dowry Prohibition Act,2013,0,0,0,0,0,0,0,0,0,0,0,0,0,0,0,0,0,0
Delhi UT,Dowry Prohibition Act,2013,40,15,0,0,1,10,1,11,43,78,10,0,88,0,2,1,1,86
Lakshadweep,Dowry Prohibition Act,2013,0,0,0,0,0,0,0,0,0,0,0,0,0,0,0,0,0,0
Puducherry,Dowry Prohibition Act,2013,11,14,0,0,2,14,0,14,9,35,14,0,49,0,2,0,2,47
